1111111111
1000000001
1011121101
1010000101
1000110101
1010110001
1010000101
1011011101
1000000001
1111111111